*GREENS EUROPEAN FREE ALLIANCE*	
AFFRONTE Marco	marco.affronte@europarl.europa.eu
*PD - Group of the progressive alliance*	
BENIFEI Brando	brando.benifei@europarl.europa.eu
BETTINI Goffredo	goffredo.bettini@europarl.europa.eu
BONAFE Simona	simona.bonafe@europarl.europa.eu
BRESSO Mercedes	mercedes.bresso@europarl.europa.eu
BRIANO Renata	renata.briano@europarl.europa.eu
CAPUTO Nicola	nicola.caputo@europarl.europa.eu
CHINNICI Caterina	caterina.chinnici@europarl.europa.eu
COSTA Silvia	silvia.costa@europarl.europa.eu
COZZOLINO Andrea	andrea.cozzolino@europarl.europa.eu
DANTI Nicola	nicola.danti@europarl.europa.eu
DECASTRO Paolo	paolo.decastro@europarl.europa.eu
DEMONTE Isabell	isabella.demonte@europarl.europa.eu
GASBARRA Enrico	enrico.gasbarra@europarl.europa.eu
GENTILE Elena	elena.gentile@europarl.europa.eu
GIUFFRIDA Michela	michela.giuffrida@europarl.europa.eu
GUALTIERI Roberto	roberto.gualtieri@europarl.europa.eu
KYENGE Kashetu	kashetu.kyenge@europarl.europa.eu
MORGANO Luigi	luigi.morgano@europarl.europa.eu
MOSCA Alessia	alessia.mosca@europarl.europa.eu
PICIERNO Giuseppina	giuseppina.picierno@europarl.europa.eu
SASSOLI David	david.sassoli@europarl.europa.eu
SORU Renato	renato.soru@europarl.europa.eu
TOIA Patrizia	patrizia.toia@europarl.europa.eu
VIOTTI Daniele	daniele.viotti@europarl.europa.eu
ZOFFOLI Damiano	damiano.zoffoli@europarl.europa.eu
ZANONATO Flavio	flavio.zanonato@europarl.europa.eu
PANZERI Pierantonio	pierantonio.panzeri@europarl.europa.eu
PAOLUCCI Massimo	massimo.paolucci@europarl.europa.eu
COFFERATI Sergio	sergio.cofferati@europarl.europa.eu
SCHLEIN Elly	elly.schlein@europarl.europa.eu
*M5S*	
ADINOLFI Isabella	isabella.adinolfi@europarl.europa.eu
AGEA Laura	laura.agea@europarl.europa.eu
AIUTO Daniela	daniela.aiuto@europarl.europa.eu
BEGHINI Tiziana	tiziana.beghin@europarl.europa.eu
BORRELLI David	david.borrelli@europarl.europa.eu
CASTALDO Fabio Massimo	fabiomassimo.castaldo@europarl.europa.eu
CORRAO Ignazio	ignazio.corrao@europarl.europa.eu
DAMATO Rosa	rosa.damato@europarl.europa.eu
EVI Eleonora	eleonora.evi@europarl.europa.eu
FERRARA Laura	laura.ferrara@europarl.europa.eu
MOI Giulia	giulia.moi@europarl.europa.eu
PEDICINI Piernicola	piernicola.pedicini@europarl.europa.eu
TAMBURRANO Dario	dario.tamburrano@europarl.europa.eu
VALLI Marco	marco.valli@europarl.europa.eu
ZULLO Marco	marco.zullo@europarl.europa.eu
LEGA NORD - EUROPE OF NATIONS AND FREEDOM GROUP	
BIZZOTTO Mara	mara.bizzotto@europarl.europa.eu
BORGHEZIO Mario	mario.borghezio@europarl.europa.eu
CIOCCA Angelo	angelo.ciocca@europarl.europa.eu
ZANNI Marco	marco.zanni@europarl.europa.eu
*FORZA ITALIA - EPP*	
CICU Salvatore	salvatore.cicu@europarl.europa.eu
CIRIO Alberto	alberto.cirio@europarl.europa.eu
COMI Lara	lara.comi@europarl.europa.eu
GARDINI Elisabetta	elisabetta.gardini@europarl.europa.eu
MARTUSCIELLO Fulvio	fulvio.martusciello@europarl.europa.eu
MATERA Barbara	barbara.matera@europarl.europa.eu
MAULLU Stefano	stefano.maullu@europarl.europa.eu
MUSSOLINI Alessandra	alessandra.mussolini@europarl.europa.eu
PATRICIELLO Aldo	aldo.patriciello@europarl.europa.eu
POGLIESE Salvatore Domenico	salvatoredomenico.pogliese@europarl.europa.eu
SALINI Massimiliano	massimiliano.salini@europarl.europa.eu
TAJANI Antonio	antonio.tajani@europarl.europa.eu
CESA Lorenzo	lorenzo.cesa@europarl.europa.eu
DORFMANN Herbert	herbert.dorfmann@europarl.europa.eu
LAVIA Giovanni	giovanni.lavia@europarl.europa.eu
*TSIPRAS - EUROPEAN LEFT*	
FORENZA Eleonora	eleonora.forenza@europarl.europa.eu
MALTESE Curzio	curzio.maltese@europarl.europa.eu
SPINELLI Barbara	barbara.spinelli@europarl.europa.eu
*CONSERVATORI E RIFORMISTI*	
FITTO Raffaele	raffaele.fitto@europarl.europa.eu
SERNAGIOTTO Remo	remo.sernagiotto@europarl.europa.eu
